{
  "1": "C",
  "2": "O",
  "3": "H",
  "4": "P",
  "5": "F",
  "6": "Li"
}
