{
  "1": "C",
  "2": "O",
  "3": "O",
  "4": "C",
  "5": "H",
  "6": "P",
  "7": "F",
  "8": "Li"
}
